.***...*.**.**..*..*...*..**..
...........*******...**...*.*.
......**.**.......**.*...*..**
*...*.....*...*.*....*.*..*..*
....*.*....*..*.*..*..*..*..*.
....**..***.*..**.**.....**...
...*...**..**....*.....*.*.*..
*.......**....*...*.**..**.*..
....*.*..*..*...***....*.....*
.*..***.*..*.*...*.**..*...**.
....**.....***....*.....*.....
.*.*..*....***...*.....*.*.**.
......*.*......*.........**...
....**.....*...**......****..*
..*..*.*..*.*..**.............
...**....****..**..*...*......
.*........**.*...*.*.*..*.*.*.
*.....***........****..*..*..*
..**.....*..*...*.........*...
....*.....*..*.*...*.**....**.
*.......**.........*****..**..
..******.*...*......**....*.**
...*...*..........**.****..**.
.............**...**.....**..*
*......**....*...*......*.....